ба бе би бо бу ба бе би бо бу ба бе би
ка ке ки ко ку ка ке ки ко ку ка ке ки
ма ме ми мо му ма ме ми мо му ма ме ми
па пе пи по пу па пе пи по пу па пе пи
та те ти то ту та те ти то ту та те ти